XXXXXXXXXXXXXXXXXXXXXXXXXXXXXXXXXXXXXXXXXXXXXXXXXXXXXXXXXXXXXXXXXXXXXXXXXXXXXXXXXXXXXXXXXXXXXXXXXXXXXXXXXXXXXXXXXXXXXXXXXXXXXXX
XXXXXXXXXXXXXXXXXXXXXXXXXXXXXXXXXXXXXXXXXXXXXXXXXXXXXXXXXXXXXXXXXXXXXXXXXXXXXXXXXXXXXXXXXXXXXXXXXXXXXXXXXXXXXXXXXXXXXXXXXXXXXXX
XXXXXXXXXXXXXXXXXXXXXXXXXXXXXXXXXXXXXXXXXXXXXXXXXXXXXXXXXXXXXXXXXXXXXXXXXXXXXXXXXXXXXXXXXXXXXXXXXXXXXXXXXXXXXXXXXXXXXXXXXXXXXXX
XXXXXXXXXXXXXXXXXXXXXXXXXXXXXXXXXXXXXXXXXXXXXXXXXXXXXXXXXXXXXXXXXXXXXXXXXXXXXXXXXXXXXXXXXXXXXXXXXXXXXXXXXXXXXXXXXXXXXXXXXXXXXXX
XXXXXXXXXXXXXXXXXXXXXXXXXXXXXXXXXXXXXXXXXXXXXXXXXXXXXXXXXXXXXXXXXXXXXXXXXXXXXXXXXXXXXXXXXXXXXXXXXXXXXXXXXXXXXXXXXXXXXXXXXXXXXXX
XXXXXXXXXXXXXXXXXXXXXXXXXXXXXXXXXXXXXXXXXXXXXXXXXXXXXXXXXXXXXXXXXXXXXXXXXXXXXXXXXXXXXXXXXXXXXXXXXXXXXXXXXXXXXXXXXXXXXXXXXXXXXXX
XXXXXXXXXXXXXXXXXXXXXXXXXXXXXXXXXXXXXXXXXXXXXXXXXXXXXXXXXXXXXXXXXXXXXXXXXXXXXXXXXXXXXXXXXXXXXXXXXXXXXXXXXXXXXXXXXXXXXXXXXXXXXXX
XXXXXXXXXXXXXXXXXXXXXXXXXXXXXXXXXXXXXXXXXXXXXXXXXXXXXXXXXXXXXXXXXXXXXXXXXXXXXXXXXXXXXXXXXXXXXXXXXXXXXXXXXXXXXXXXXXXXXXXXXXXXXXX
XXXXXXXXXXXXXXXXXXXXXXXXXXXXXXXXXXXXXXXXXXXXXXXXXXXXXXXXXXXXXXXXXXXXXXXXXXXXXXXXXXXXXXXXXXXXXXXXXXXXXXXXXXXXXXXXXXXXXXXXXXXXXXX
XXXXXXXXXXXXXXXXXXXXXXXFFFFFFFFFFFFFFFFFFFFFFFFFFFFFFFFFFFFFFFFFFXXXXXXXXXXXXXXXXXXFFFFFFFFFFFFFFFFFFFFFFFFFFXXXXXXXXXXXXXXXXXX
XXXXXXXXXXXXXXXXXXXXXXXFFFFFFFFFFFFFFFFFFFFFFFFFFFFFFFFFFFFFFFFFFXXXXXXXXXXXXXXXXXXFFFFFFFFFFFFFFFFFFFFFFFFFFXXXXXXXXXXXXXXXXXX
XXXXXXXXXXXXXXXXXXXXXXXFTTTTTTTTTTTTTTTTTTTTTTTTTTTTTTTTTTTTTTTTFXXXXXXXXXXXXXXXXXXFTTTTTTTTTTTTTTTTTTTTTTTTFXXXXXXXXXXXXXXXXXX
XXXXXXXXXXXXXXXXXXXXXXXFTTTTTTTTTTTTTTTTTTTTTTTTTTTTTTTTTTTTTTTTFXXXXXXXXXXXXXXXXXXFTTTTTTTTTTTTTTTTTTTTTTTTFXXXXXXXXXXXXXXXXXX
XXXXXXXXXXXXXXXXXXXXXXXFTTTTTTTTTTTTTTTTTTTTTTTTTTTTTTTTTTTTTTTTFXXXXXXXXXXXXXXXXXXFTTTTTTTTTTTTTTTTTTTTTTTTFXXXXXXXXXXXXXXXXXX
XXXXXXXXXXXXXXXXXXXXXXXFTTTTTTTTTTTTTTTTTTTTTTTTTTTTTTTTTTTTTTTTFXXXXXXXXXXXXXXXXXXFTTTTTTTTTTTTTTTTTTTTTTTTFXXXXXXXXXXXXXXXXXX
XXXXXXXXXXXXXXXXXXXXXXXFTTTTFFFFFFFFFFFFTTTTFFFFFFFFFFFFFFFFTTTTFXXXXXXXXXXXXXXXXXXFTTTTFFFFFFFFFFFFTTTTFFFFFXXXXXXXXXXXXXXXXXX
XXXXXXXXXXXXXXXXXXXXXXXFTTTTFXXXXXXXXXXFTTTTFXXXXXXXXXXXXXXFTTTTFXXXXXXXXXXXXXXXXXXFTTTTFXXXXXXXXXXFTTTTFXXXXXXXXXXXXXXXXXXXXXX
XXXXXXXXXXXXXXXXXXXXXXXFTTTTFXXXXXXXXXXFTTTTFXXXXXXXXXXXXXXFTTTTFXXXXXXXXXXXXXXXXXXFTTTTFXXXXXXXXXXFTTTTFXXXXXXXXXXXXXXXXXXXXXX
XXXXXXXXXXXXXXXXXXXXXXXFTTTTFXXXXXXXXXXFTTTTFXXXXXXXXXXXXXXFTTTTFXXXXXXXXXXXXXXXXXXFTTTTFXXXXXXXXXXFTTTTFXXXXXXXXXXXXXXXXXXXXXX
XXXXXXXXXXXXXXXXXXXXXXXFTTTTFXXXXXXXXXXFTTTTFXXXXXXXXXXXXXXFTTTTFXXXXXXXXXXXXXXXXXXFTTTTFXXXXXXXXXXFTTTTFXXXXXXXXXXXXXXXXXXXXXX
XXXXXXXXXXXXXXXXXXXXXXXFTTTTFXXXXXXXXXXFTTTTFXXXXXXXXXXXXXXFTTTTFXXXXXXXXXXXXXXXXXXFTTTTFXXXXXXXXXXFTTTTFXXXXXXXXXXXXXXXXXXXXXX
XXXXXXXXXXXXXXXXXXXXXXXFTTTTFXXXXXXXXXXFTTTTFXXXXXXXXXXXXXXFTTTTFFFFFFFFFFFFFFFFFFFFTTTTFXXXXXXXXXXFTTTTFXXXXXXXXXXXXXXXXXXXXXX
XXXXXXXXXXXXXXXXXXXXXXXFTTTTFXXXXXXXXXXFTTTTFXXXXXXXXXXXXXXFTTTTFFFFFFFFFFFFFFFFFFFFTTTTFXXXXXXXXXXFTTTTFXXXXXXXXXXXXXXXXXXXXXX
XXXXXXXXXXXXXXXXXXXXXXXFTTTTFXXXXXXXXXXFTTTTFXXXXXXXXXXXXXXFTTTTTTTTTTTTTTTTTTTTTTTTTTTTFXXXXXXXXXXFTTTTFXXXXXXXXXXXXXXXXXXXXXX
XXXXXXXXXXXXXXXXXXXXXXXFTTTTFXXXXXXXXXXFTTTTFXXXXXXXXXXXXXXFTTTTTTTTTTTTTTTTTTTTTTTTTTTTFXXXXXXXXXXFTTTTFXXXXXXXXXXXXXXXXXXXXXX
XXXXXXXXXXXXXXXXXXXXXXXFTTTTFFFFFFFFFFFFTTTTFXXXXXXXXXXXXXXFTTTTTTTTTTTTTTTTTTTTTTTTTTTTFXXXXXXXXXXFTTTTFFFFFXXXXXXXXXXXXXXXXXX
XXXXXXXXXXXXXXXXXXXXXXXFTTTTFFFFFFFFFFFFTTTTFXXXXXXXXXXXXXXFTTTTTTTTTTTTTTTTTTTTTTTTTTTTFXXXXXXXXXXFTTTTFFFFFXXXXXXXXXXXXXXXXXX
XXXXXXXXXXXXXXXXXXXXXXXFTTTTTTTTTTTTTTTTTTTTFXXXXXXXXXXXXXXFFFFFFFFFTTTTFFFFFFFFFFFFTTTTFXXXXXXXXXXFTTTTTTTTFXXXXXXXXXXXXXXXXXX
XXXXXXXXXXXXXXXXXXXXXXXFTTTTTTTTTTTTTTTTTTTTFXXXXXXXXXXXXXXXXXXXXXXFTTTTFXXXXXXXXXXFTTTTFXXXXXXXXXXFTTTTTTTTFXXXXXXXXXXXXXXXXXX
XXXXXXXXXXXXXXXXXXXXXXXFTTTTTTTTTTTTTTTTTTTTFXXXXXXXXXXXXXXXXXXXXXXFTTTTFXXXXXXXXXXFTTTTFXXXXXXXXXXFTTTTTTTTFXXXXXXXXXXXXXXXXXX
XXXXXXXXXXXXXXXXXXXXXXXFTTTTTTTTTTTTTTTTTTTTFXXXXXXXXXXXXXXXXXXXXXXFTTTTFXXXXXXXXXXFTTTTFXXXXXXXXXXFTTTTTTTTFXXXXXXXXXXXXXXXXXX
XXXXXXXXXXXXXXXXXXXXXXXFTTTTFFFFFFFFFFFFFFFFFXXXXXXXXXXXXXXXXXXXXXXFFFFFFXXXXXXXXXXFTTTTFXXXXXXXXXXFFFFFFFFFFXXXXXXXXXXXXXXXXXX
XXXXXXXXXXXXXXXXXXXXXXXFTTTTFXXXXXXXXXXXXXXXXXXXXXXXXXXXXXXXXXXXXXXXXXXXXXXXXXXXXXXFTTTTFXXXXXXXXXXXXXXXXXXXXXXXXXXXXXXXXXXXXXX
XXXXXXXXXXXXXXXXXXXXXXXFTTTTFXXXXXXXXXXXXXXXXXXXXXXXXXXXXXXXXXXXXXXXXXXXXXXXXXXXXXXFTTTTFXXXXXXXXXXXXXXXXXXXXXXXXXXXXXXXXXXXXXX
XXXXXXXXXXXXXXXXXXXXXXXFTTTTFXXXXXXXXXXXXXXXXXXXXXXXXXXXXXXXXXXXXXXXXXXXXXXXXXXXXXXFTTTTFXXXXXXXXXXXXXXXXXXXXXXXXXXXXXXXXXXXXXX
XXXXXXXXXXXXXXXXXXXXXXXFTTTTFXXXXXXXXXXXXXXXXXXXXXXXXXXXXXXXXXXXXXXXXXXXXXXXXXXXXXXFTTTTFXXXXXXXXXXXXXXXXXXXXXXXXXXXXXXXXXXXXXX
XXXXXXXXXXXXXXXXXXXXXXXFTTTTFXXXXXXXXXXXXXXXXXXXXXXXXXXXXXXXXXXXXXXXXXXXXXXXXXXXXXXFTTTTFXXXXXXXXXXXXXXXXXXXXXXXXXXXXXXXXXXXXXX
XXXXXXXXXXXXXXXXXXXXXXXFTTTTFXXXXXXXXXXXXXXXXXXXXXXXXXXXXXXXXXXXXXXXXXXXXXXXXXXXXXXFTTTTFFFFFFFFFFFFFXXXXXXXXXXXXXXXXXXXXXXXXXX
XXXXXXXXXXXXXXXXXXXXXXXFTTTTFXXXXXXXXXXXXXXXXXXXXXXXXXXXXXXXXXXXXXXXXXXXXXXXXXXXXXXFTTTTFFFFFFFFFFFFFXXXXXXXXXXXXXXXXXXXXXXXXXX
XXXXXXXXXXXXXXXXXXXXXXXFTTTTFXXXXXXXXXXXXXXXXXXXXXXXXXXXXXXXXXXXXXXXXXXXXXXXXXXXXXXFTTTTTTTTTTTTTTTTFXXXXXXXXXXXXXXXXXXXXXXXXXX
XXXXXXXXXXXXXXXXXXXXXXXFTTTTFXXXXXXXXXXXXXXXXXXXXXXXXXXXXXXXXXXXXXXXXXXXXXXXXXXXXXXFTTTTTTTTTTTTTTTTFXXXXXXXXXXXXXXXXXXXXXXXXXX
XXXXXXXXXXXXXXXXXXXXXXXFTTTTFXXXXXXXXXXFFFFFFFFFFFFFFFFFFFFFFFFFFFFFFXXXXXXXXXXXXXXFTTTTTTTTTTTTTTTTFXXXXXXXXXXXXXXXXXXXXXXXXXX
XXXXXXXXXXXXXXXXXXXXXXXFTTTTFXXXXXXXXXXFFFFFFFFFFFFFFFFFFFFFFFFFFFFFFXXXXXXXXXXXXXXFTTTTTTTTTTTTTTTTFXXXXXXXXXXXXXXXXXXXXXXXXXX
XXXXXXXXXXXXXXXXXXXXXXXFTTTTFXXXXXXXXXXFTTTTTTTTTTTTTTTTTTTTTTTTTTTTFXXXXXXXXXXXXXXFTTTTFFFFFFFFTTTTFXXXXXXXXXXXXXXXXXXXXXXXXXX
XXXXXXXXXXXXXXXXXXXXXXXFTTTTFXXXXXXXXXXFTTTTTTTTTTTTTTTTTTTTTTTTTTTTFXXXXXXXXXXXXXXFTTTTFXXXXXXFTTTTFXXXXXXXXXXXXXXXXXXXXXXXXXX
XXXXXXXXXXXXXXXXXXXXXXXFTTTTFXXXXXXXXXXFTTTTTTTTTTTTTTTTTTTTTTTTTTTTFXXXXXXXXXXXXXXFTTTTFXXXXXXFTTTTFFFFFFFFFXXXXXXXXXXXXXXXXXX
XXXXXXXXXXXXXXXXXXXXXXXFTTTTFXXXXXXXXXXFTTTTTTTTTTTTTTTTTTTTTTTTTTTTFXXXXXXXXXXXXXXFTTTTFXXXXXXFTTTTFFFFFFFFFXXXXXXXXXXXXXXXXXX
XXXXXXXXXXXXXXXXXXXXXXXFTTTTFXXXXXXXXXXFTTTTFFFFFFFFFFFFFFFFFFFFTTTTFXXXXXXXXXXXXXXFTTTTFXXXXXXFTTTTTTTTTTTTFXXXXXXXXXXXXXXXXXX
XXXXXXXXXXXXXXXXXXXXXXXFTTTTFXXXXXXXXXXFTTTTFXXXXXXXXXXXXXXXXXXFTTTTFXXXXXXXXXXXXXXFTTTTFXXXXXXFTTTTTTTTTTTTFXXXXXXXXXXXXXXXXXX
XXXXXXXXXXXXXXXXXXXXXXXFTTTTFXXXXXXXXXXFTTTTFXXXXXXXXXXXXXXXXXXFTTTTFXXXXXXXXXXXXXXFTTTTFXXXXXXFTTTTTTTTTTTTFXXXXXXXXXXXXXXXXXX
XXXXXXXXXXXXXXXXXXXXXXXFTTTTFXXXXXXXXXXFTTTTFXXFFFFFFFFFFFFFFXXFTTTTFXXXXXXXXXXXXXXFTTTTFXXXXXXFTTTTTTTTTTTTFXXXXXXXXXXXXXXXXXX
XXXXXXXXXXXXXXXXXXXXXXXFTTTTFXXXXXXXXXXFTTTTFXXFTTTTTTTTTTTTFXXFTTTTFXXXXXXXXXXXXXXFTTTTFXXXXXXFTTTTFFFFFFFFFXXXXXXXXXXXXXXXXXX
XXXXXXXXXXXXXXXXXXXXXXXFTTTTFXXXXXXXXXXFTTTTFXXFTTTTTTTTTTTTFXXFTTTTFXXXXXXXXXXXXXXFTTTTFXXXXXXFTTTTFXXXXXXXXXXXXXXXXXXXXXXXXXX
XXXXXXXXXXXXXXXXXXXXXXXFTTTTFFFFFFFFFFFFTTTTFXXFTTTTTTTTTTTTFXXFTTTTFXXXXXXXXXXXXXXFTTTTFFFFFFFFTTTTFXXXXXXXXXXXXXXXXXXXXXXXXXX
XXXXXXXXXXXXXXXXXXXXXXXFTTTTFFFFFFFFFFFFTTTTFXXFTTTTTTTTTTTTFFFFTTTTFXXXXXXXXXXXXXXFTTTTFFFFFFFFTTTTFXXXXXXXXXXXXXXXXXXXXXXXXXX
XXXXXXXXXXXXXXXXXXXXXXXFTTTTTTTTTTTTTTTTTTTTFXXFTTTTTTTTTTTTTTTTTTTTFXXXXXXXXXXXXXXFTTTTTTTTTTTTTTTTFXXXXXXXXXXXXXXXXXXXXXXXXXX
XXXXXXXXXXXXXXXXXXXXXXXFTTTTTTTTTTTTTTTTTTTTFXXFTTTTTTTTTTTTTTTTTTTTFXXXXXXXXXXXXXXFTTTTTTTTTTTTTTTTFXXXXXXXXXXXXXXXXXXXXXXXXXX
XXXXXXXXXXXXXXXXXXXXXXXFTTTTTTTTTTTTTTTTTTTTFXXFTTTTTTTTTTTTTTTTTTTTFXXXXXXXXXXXXXXFTTTTTTTTTTTTTTTTFXXXXXXXXXXXXXXXXXXXXXXXXXX
XXXXXXXXXXXXXXXXXXXXXXXFTTTTTTTTTTTTTTTTTTTTFXXFTTTTTTTTTTTTTTTTTTTTFXXXXXXXXXXXXXXFTTTTTTTTTTTTTTTTFXXXXXXXXXXXXXXXXXXXXXXXXXX
XXXXXXXXXXXXXXXXXXXXXXXFTTTTFFFFFFFFFFFFTTTTFXXFTTTTTTTTTTTTFFFFTTTTFXXXXXXXXXXXXXXFTTTTFFFFFFFFFFFFFXXXXXXXXXXXXXXXXXXXXXXXXXX
XXXXXXXXXXXXXXXXXXXXXXXFTTTTFXXXXXXXXXXFTTTTFXXFTTTTTTTTTTTTFXXFTTTTFXXXXXXXXXXXXXXFTTTTFXXXXXXXXXXXXXXXXXXXXXXXXXXXXXXXXXXXXXX
XXXXXXXXXXXXXXXFFFFFFFFFTTTTFXXXXXXXXXXFTTTTFXXFTTTTTTTTTTTTFXXFTTTTFXXXXXXXXXXXXXXFTTTTFXXXXXXXXXXXXXXXXXXXXXXXXXXXXXXXXXXXXXX
XXXXXXXXXXXXXXXFFFFFFFFFTTTTFXXXXXXXXXXFTTTTFXXFTTTTTTTTTTTTFXXFTTTTFXXXXXXXXXXXXXXFTTTTFXXXXXXXXXXXXXXXXXXXXXXXXXXXXXXXXXXXXXX
XXXXXXXXXXXXXXXFTTTTTTTTTTTTFXXXXXXXXXXFTTTTFXXFFFFFFFFFFFFFFXXFTTTTFXXXXXXXXXXXXXXFTTTTFXXXXXXXXXXXXXXXXXXXXXXXXXXXXXXXXXXXXXX
XXXXXXXXXXXXXXXFTTTTTTTTTTTTFXXXXXXXXXXFTTTTFXXXXXXXXXXXXXXXXXXFTTTTFXXXXXXXXXXXXXXFTTTTFXXXXXXXXXXXXXXXXXXXXXXXXXXXXXXXXXXXXXX
XXXXXXXXXXXXXXXFTTTTTTTTTTTTFXXXXXXXXXXFTTTTFXXXXXXXXXXXXXXXXXXFTTTTFXXXXXXXXXXFFFFFTTTTFXXXXXXXXXXFFFFFFFFFFXXXXXXXXXXXXXXXXXX
XXXXXXXXXXXXXXXFTTTTTTTTTTTTFXXXXXXXXXXFTTTTFFFFFFFFFFFFFFFFFFFFTTTTFXXXXXXXXXXFFFFFTTTTFXXXXXXXXXXFFFFFFFFFFXXXXXXXXXXXXXXXXXX
XXXXXXXXXXXXXXXFTTTTFFFFTTTTFXXXXXXXXXXFTTTTTTTTTTTTTTTTTTTTTTTTTTTTFXXXXXXXXXXFTTTTTTTTFXXXXXXXXXXFTTTTTTTTFXXXXXXXXXXXXXXXXXX
XXXXXXXXXXXXXXXFTTTTFXXFTTTTFXXXXXXXXXXFTTTTTTTTTTTTTTTTTTTTTTTTTTTTFXXXXXXXXXXFTTTTTTTTFXXXXXXXXXXFTTTTTTETFXXXXXXXXXXXXXXXXXX
XXXXXXXXXXXXXXXFTTTTFXXFTTTTFXXXXXXXXXXFTTTTTTTTTTTTTTTTTTTTTTTTTTTTFXXXXXXXXXXFTTTTTTTTFXXXXXXXXXXFTTTTTTTTFXXXXXXXXXXXXXXXXXX
XXXXXXXXXXXXXXXFTTTTFXXFTTTTFXXXXXXXXXXFTTTTTTTTTTTTTTTTTTTTTTTTTTTTFXXXXXXXXXXFTTTTTTTTFXXXXXXXXXXFTTTTTTTTFXXXXXXXXXXXXXXXXXX
XXXXXXXXXXXXXXXFTTTTFXXFTTTTFXXXXXXXXXXFFFFFFFFFFFFFFFFFFFFFFFFFFFFFFXXXXXXXXXXFFFFFTTTTFXXXXXXXXXXFTTTTFFFFFXXXXXXXXXXXXXXXXXX
XXXXXXXXXXXXXXXFTTTTFXXFTTTTFXXXXXXXXXXXXXXXXXXXXXXXXXXXXXXXXXXXXXXXXXXXXXXXXXXXXXXFTTTTFXXXXXXXXXXFTTTTFXXXXXXXXXXXXXXXXXXXXXX
XXXXXXXXXXXXXXXFTTTTFFFFTTTTFXXXXXXXXXXXXXXXXXXXXXXXXXXXXXXXXXXXXXXXXXXXXXXXXXXXXXXFTTTTFXXXXXXXXXXFTTTTFXXXXXXXXXXXXXXXXXXXXXX
XXXXXXXXXXXXXXXFTTTTFFFFTTTTFXXXXXXXXXXXXXXXXXXXXXXXXXXXXXXXXXXXXXXXXXXXXXXXXXXXXXXFTTTTFXXXXXXXXXXFTTTTFXXXXXXXXXXXXXXXXXXXXXX
XXXXXXXXXXXXXXXFTTTTTTTTTTTTFXXXXXXXXXXXXXXXXXXXXXXXXXXXXXXXXXXXXXXXXXXXXXXXXXXXXXXFTTTTFXXXXXXXXXXFTTTTFXXXXXXXXXXXXXXXXXXXXXX
XXXXXXXXXXXXXXXFTTTTTTTTTTTTFXXXXXXXXXXXXXXXXXXXXXXXXXXXXXXXXXXXXXXXXXXXXXXXXXXXXXXFTTTTFXXXXXXXXXXFTTTTFXXXXXXXXXXXXXXXXXXXXXX
XXXXXXXXXXXXXXXFTTTTTTTTTTTTFXXXXXXFFFFFFFFFFFFFFFFFFFFFFXXXXXXXXXXXXXXXXXXXXXXXXXXFTTTTFXXXXXXXXXXFTTTTFXXXXXXXXXXXXXXXXXXXXXX
XXXXXXXXXXXXXXXFTTTTTTTTTTTTFXXXXXXFFFFFFFFFFFFFFFFFFFFFFXXXXXXXXXXXXXXXXXXXXXXXXXXFTTTTFXXXXXXXXXXFTTTTFXXXXXXXXXXXXXXXXXXXXXX
XXXXXXXXXXXXXXXFFFFFFFFFTTTTFXXXXXXFTTTTTTTTTTTTTTTTTTTTFXXXXXXXXXXXXXXXXXXXXXXXXXXFTTTTFXXXXXXXXXXFTTTTFXXXXXXXXXXXXXXXXXXXXXX
XXXXXXXXXXXXXXXXXXXXXXXFTTTTFXXXXXXFTTTTTTTTTTTTTTTTTTTTFXXXXXXXXXXXXXXXXXXXXXXXXXXFTTTTFXXXXXXXXXXFTTTTFXXXXXXXXXXXXXXXXXXXXXX
XXXXXXXXXXXXXXXXXXXXXXXFTTTTFXXXXXXFTTTTTTTTTTTTTTTTTTTTFXXXXXXXXXXXXXXXXXXFFFFFFFFFTTTTFFFFFFFFFFFFTTTTFXXXXXXXXXXXXXXXXXXXXXX
XXXXXXXXXXXXXXXXXXXXXXXFTTTTFXXXXXXFTTTTTTTTTTTTTTTTTTTTFXXXXXXXXXXXXXXXXXXFFFFFFFFFTTTTFFFFFFFFFFFFTTTTFXXXXXXXXXXXXXXXXXXXXXX
XXXXXXXXXXXXXXXXXXXXXXXFTTTTFXXXXXXFTTTTFFFFFFFFFFFFTTTTFXXXXXXXXXXXXXXXXXXFTTTTTTTTTTTTTTTTTTTTTTTTTTTTFXXXXXXXXXXXXXXXXXXXXXX
XXXXXXXXXXXXXXXXXXXXXXXFTTTTFXXXXXXFTTTTFXXXXXXXXXXFTTTTFXXXXXXXXXXXXXXXXXXFTTTTTTTTTTTTTTTTTTTTTTTTTTTTFXXXXXXXXXXXXXXXXXXXXXX
XXXXXXXXXXXXXXXXXXXXXXXFTTTTFFFFFFFFTTTTFFFFFFFFFFFFTTTTFFFFFFFFFXXXXXXXXXXFTTTTTTTTTTTTTTTTTTTTTTTTTTTTFXXXXXXXXXXXXXXXXXXXXXX
XXXXXXXXXXXXXXXXXXXXXXXFTTTTFFFFFFFFTTTTFFFFFFFFFFFFTTTTFFFFFFFFFXXXXXXXXXXFTTTTTTTTTTTTTTTTTTTTTTTTTTTTFXXXXXXXXXXXXXXXXXXXXXX
XXXXXXXXXXXXXXXXXXXXXXXFTTTTTTTTTTTTTTTTTTTTTTTTTTTTTTTTTTTTTTTTFXXXXXXXXXXFTTTTFFFFFFFFFFFFFFFFFFFFFFFFFXXXXXXXXXXXXXXXXXXXXXX
XXXXXXXXXXXXXXXXXXXXXXXFTTTTTTTTTTTTTTTTTTTTTTTTTTTTTTTTTTTTTTTTFXXXXXXXXXXFTTTTFXXXXXXXXXXXXXXXXXXXXXXXXXXXXXXXXXXXXXXXXXXXXXX
XXXXXXXXXXXXXXXXXXXXXXXFTTTTTTTTTTTTTTTTTTTTTTTTTTTTTTTTTTTTTTTTFXXXXXXXXXXFTTTTFXXXXXXXXXXXXXXXXXXXXXXXXXXXXXXXXXXXXXXXXXXXXXX
XXXXXXXXXXXXXXXXXXXXXXXFTTTTTTTTTTTTTTTTTTTTTTTTTTTTTTTTTTTTTTTTFXXXXXXXXXXFTTTTFXXXXXXXXXXXXXXXXXXXXXXXXXXXXXXXXXXXXXXXXXXXXXX
XXXXXXXXXXXXXXXXXXXXXXXFTTTTFFFFFFFFFFFFFFFFFFFFFFFFFFFFFFFFTTTTFXXXXXXXXXXFTTTTFXXXXXXXXXXXXXXXXXXXXXXXXXXXXXXXXXXXXXXXXXXXXXX
XXXXXXXXXXXXXXXXXXXXXXXFTTTTFXXXXXXXXXXXXXXXXXXXXXXXXXXXXXXFTTTTFXXXXXXXXXXFTTTTFXXXXXXXXXXXXXXXXXXXXXXXXXXXXXXXXXXXXXXXXXXXXXX
XXXXXXXXXXXXXXXXXXXXXXXFTTTTFXXXXXXXXXXXXXXXXXXXXXXXXXXXXXXFTTTTFXXXXXXXXXXFTTTTFXXXXXXXXXXXXXXXXXXXXXXXXXXXXXXXXXXXXXXXXXXXXXX
XXXXXXXXXXXXXXXXXXXXXXXFTTTTFXXXXXXXXXXXXXXXXXXXXXXXXXXXXXXFTTTTFXXXXXXXXXXFTTTTFXXXXXXXXXXXXXXXXXXXXXXXXXXXXXXXXXXXXXXXXXXXXXX
XXXXXXXXXXXXXXXXXXXXXXXFTTTTFXXXXXXXXXXXXXXXXXXXXXXXXXXXXXXFTTTTFXXXXXXXXXXFTTTTFXXXXXXXXXXXXXXXXXXXXXXXXXXXXXXXXXXXXXXXXXXXXXX
XXXXXXXXXXXXXXXXXXXXXXXFTTTTFXXXXXXXXXXXXXXXXXXXXXXXXXXXXXXFTTTTFXXXXXXXXXXFTTTTFXXXXXXXXXXXXXXXXXXXXXXXXXXXXXXXXXXXXXXXXXXXXXX
XXXXXXXXXXXXXXXFFFFFFFFFTTTTFFFFFFFFFXXXXXXXXXXXXXXXXXXXXXXFTTTTFFFFFFFFFFFFTTTTFXXXXXXXXXXFFFFFFXXXXXXXXXXXXXXXXXXXXXXXXXXXXXX
XXXXXXXXXXXXXXXFFFFFFFFFTTTTFFFFFFFFFXXXXXXXXXXXXXXXXXXXXXXFTTTTFFFFFFFFFFFFTTTTFXXXXXXXXXXFFFFFFXXXXXXXXXXXXXXXXXXXXXXXXXXXXXX
XXXXXXXXXXXXXXXFTTTTTTTTTTTTTTTTTTTTFXXXXXXXXXXXXXXXXXXXXXXFTTTTTTTTTTTTTTTTTTTTFXXXXXXXXXXFTTTTFXXXXXXXXXXXXXXXXXXXXXXXXXXXXXX
XXXXXXXXXXXXXXXFTTTTTTTTTTTTTTTTTTTTFXXXXXXXXXXXXXXXXXXXXXXFTTTTTTTTTTTTTTTTTTTTFXXXXXXXXXXFTTTTFXXXXXXXXXXXXXXXXXXXXXXXXXXXXXX
XXXXXXXXXXXXXXXFTTTTTTTTTTTTTTTTTTTTFXXXXXXXXXXXXXXXXXXXXXXFTTTTTTTTTTTTTTTTTTTTFXXXXXXXXXXFTTTTFXXXXXXXXXXXXXXXXXXXXXXXXXXXXXX
XXXXXXXXXXXXXXXFTTTTTTTTTTTTTTTTTTTTFXXXXXXXXXXXXXXXXXXXXXXFTTTTTTTTTTTTTTTTTTTTFXXXXXXXXXXFTTTTFXXXXXXXXXXXXXXXXXXXXXXXXXXXXXX
XXXXXXXXXXXXXXXFTTTTFFFFFFFFFFFFTTTTFXXXXXXXXXXXXXXXXXXXXXXFFFFFFFFFFFFFFFFFTTTTFXXXXXXXXXXFTTTTFXXXXXXXXXXXXXXXXXXXXXXXXXXXXXX
XXXXXXXXXXXXXXXFTTTTFXXXXXXXXXXFTTTTFXXXXXXXXXXXXXXXXXXXXXXXXXXXXXXXXXXXXXXFTTTTFXXXXXXXXXXFTTTTFXXXXXXXXXXXXXXXXXXXXXXXXXXXXXX
XXXXXXXXXXXXXXXFTTTTFXXXXXXXXXXFTTTTFFFFFFFFFFFFFXXXXXXXXXXXXXXXXXXXXXXXXXXFTTTTFFFFFFFFFFFFTTTTFXXXXXXXXXXXXXXXXXXXXXXXXXXXXXX
XXXXXXXXXXXXXXXFTTTTFXXXXXXXXXXFTTTTFFFFFFFFFFFFFXXXXXXXXXXXXXXXXXXXXXXXXXXFTTTTFFFFFFFFFFFFTTTTFXXXXXXXXXXXXXXXXXXXXXXXXXXXXXX
XXXXXXXXXXXXXXXFTTTTFXXXXXXXXXXFTTTTTTTTTTTTTTTTFXXXXXXXXXXXXXXXXXXXXXXXXXXFTTTTTTTTTTTTTTTTTTTTFXXXXXXXXXXXXXXXXXXXXXXXXXXXXXX
XXXXXXXXXXXXXXXFTTTTFXXXXXXXXXXFTTTTTTTTTTTTTTTTFXXXXXXXXXXXXXXXXXXXXXXXXXXFTTTTTTTTTTTTTTTTTTTTFXXXXXXXXXXXXXXXXXXXXXXXXXXXXXX
XXXXXXXXXXXXXXXFTTTTFXXXXXXXXXXFTTTTTTTTTTTTTTTTFXXXXXXXXXXXXXXXXXXXXXXXXXXFTTTTTTTTTTTTTTTTTTTTFXXXXXXXXXXXXXXXXXXXXXXXXXXXXXX
XXXXXXXXXXXXXXXFTTTTFXXXXXXXXXXFTTTTTTTTTTTTTTTTFXXXXXXXXXXXXXXXXXXXXXXXXXXFTTTTTTTTTTTTTTTTTTTTFXXXXXXXXXXXXXXXXXXXXXXXXXXXXXX
XXXXXXXXXXXXXXXFTTTTFXXXXXXXXXXFTTTTFFFFFFFFFFFFFXXXXXXXXXXXXXXXXXXXXXXXXXXFTTTTFFFFFFFFFFFFFFFFFXXXXXXXXXXXXXXXXXXXXXXXXXXXXXX
XXXXXXXXXXXXXXXFTTTTFXXXXXXXXXXFTTTTFXXXXXXXXXXXXXXXXXXXXXXXXXXXXXXXXXXXXXXFTTTTFXXXXXXXXXXXXXXXXXXXXXXXXXXXXXXXXXXXXXXXXXXXXXX
XXXXXXXXXXXXXXXFTTTTFFFFFFFFFFFFTTTTFXXXXXXXXXXXXXXXXXXXXXXXXXXXXXXXXXXXXXXFTTTTFXXXXXXXXXXXXXXXXXXXXXXXXXXXXXXXXXXXXXXXXXXXXXX
XXXXXXXXXXXXXXXFTTTTFFFFFFFFFFFFTTTTFXXXXXXXXXXXXXXXXXXXXXXXXXXXXXXXXXXXXXXFTTTTFXXXXXXXXXXXXXXXXXXXXXXXXXXXXXXXXXXXXXXXXXXXXXX
XXXXXXXXXXXXXXXFTTTTTTTTTTTTTTTTTTTTFXXXXXXXXXXXXXXXXXXXXXXXXXXXXXXXXXXXXXXFFFFFFXXXXXXXXXXXXXXXXXXXXXXXXXXXXXXXXXXXXXXXXXXXXXX
XXXXXXXXXXXXXXXFTTTTTTTTTTTTTTTTTTTTFXXXXXXXXXXXXXXXXXXXXXXXXXXXXXXXXXXXXXXXXXXXXXXXXXXXXXXXXXXXXXXXXXXXXXXXXXXXXXXXXXXXXXXXXXX
XXXXXXXXXXXXXXXFTTTTTTTTTTTTTTTTTTTTFXXXXXXXXXXXXXXXXXXXXXXXXXXXXXXXXXXXXXXXXXXXXXXXXXXXXXXXXXXXXXXXXXXXXXXXXXXXXXXXXXXXXXXXXXX
XXXXXXXXXXXXXXXFTTTTTTTTTTTTTTTTTTTTFXXXXXXXXXXXXXXXXXXXXXXXXXXXXXXXXXXXXXXXXXXXXXXXXXXXXXXXXXXXXXXXXXXXXXXXXXXXXXXXXXXXXXXXXXX
XXXXXXXXXXXXXXXFFFFFFFFFFFFFFFFFFFFFFXXXXXXXXXXXXXXXXXXXXXXXXXXXXXXXXXXXXXXXXXXXXXXXXXXXXXXXXXXXXXXXXXXXXXXXXXXXXXXXXXXXXXXXXXX
XXXXXXXXXXXXXXXXXXXXXXXXXXXXXXXXXXXXXXXXXXXXXXXXXXXXXXXXXXXXXXXXXXXXXXXXXXXXXXXXXXXXXXXXXXXXXXXXXXXXXXXXXXXXXXXXXXXXXXXXXXXXXXX
XXXXXXXXXXXXXXXXXXXXXXXXXXXXXXXXXXXXXXXXXXXXXXXXXXXXXXXXXXXXXXXXXXXXXXXXXXXXXXXXXXXXXXXXXXXXXXXXXXXXXXXXXXXXXXXXXXXXXXXXXXXXXXX
XXXXXXXXXXXXXXXXXXXXXXXXXXXXXXXXXXXXXXXXXXXXXXXXXXXXXXXXXXXXXXXXXXXXXXXXXXXXXXXXXXXXXXXXXXXXXXXXXXXXXXXXXXXXXXXXXXXXXXXXXXXXXXX
XXXXXXXXXXXXXXXXXXXXXXXXXXXXXXXXXXXXXXXXXXXXXXXXXXXXXXXXXXXXXXXXXXXXXXXXXXXXXXXXXXXXXXXXXXXXXXXXXXXXXXXXXXXXXXXXXXXXXXXXXXXXXXX
XXXXXXXXXXXXXXXXXXXXXXXXXXXXXXXXXXXXXXXXXXXXXXXXXXXXXXXXXXXXXXXXXXXXXXXXXXXXXXXXXXXXXXXXXXXXXXXXXXXXXXXXXXXXXXXXXXXXXXXXXXXXXXX
XXXXXXXXXXXXXXXXXXXXXXXXXXXXXXXXXXXXXXXXXXXXXXXXXXXXXXXXXXXXXXXXXXXXXXXXXXXXXXXXXXXXXXXXXXXXXXXXXXXXXXXXXXXXXXXXXXXXXXXXXXXXXXX
XXXXXXXXXXXXXXXXXXXXXXXXXXXXXXXXXXXXXXXXXXXXXXXXXXXXXXXXXXXXXXXXXXXXXXXXXXXXXXXXXXXXXXXXXXXXXXXXXXXXXXXXXXXXXXXXXXXXXXXXXXXXXXX
XXXXXXXXXXXXXXXXXXXXXXXXXXXXXXXXXXXXXXXXXXXXXXXXXXXXXXXXXXXXXXXXXXXXXXXXXXXXXXXXXXXXXXXXXXXXXXXXXXXXXXXXXXXXXXXXXXXXXXXXXXXXXXX