XXXXXXXXXXXXXXXXXXXXXXXXXXXXXXXXXXXXXXXXXXXXXXXXXXXXXXXXXXXXXXXXXXXXXXXXXXXXXXXXXXXXXXXXXXXXXXXXXXXXXXXXXXXXXXXXXXXXXXXXXXXXXXX
XXXXXXXXXXXXXXXXXXXXXXXXXXXXXXXXXXXXXXXXXXXXXXXXXXXXXXXXXXXXXXXXXXXXXXXXXXXXXXXXXXXXXXXXXXXXXXXXXXXXXXXXXXXXXXXXXXXXXXXXXXXXXXX
XXXXXXXXXXXXXXXXXXXXXXXXXXXXXXXXXXXXXXXXXXXXXXXXXXXXXXXXXXXXXXXXXXXXXXXXXXXXXXXXXXXXXXXXXXXXXXXXXXXXXXXXXXXXXXXXXXXXXXXXXXXXXXX
XXXXXXXXXXXXXXXXXXXXXXXXXXXXXXXXXXXXXXXXXXXXXXXXXXXXXXXXXXXXXXXXXXXXXXXXXXXXXXXXXXXXXXXXXXXXXXXXXXXXXXXXXXXXXXXXXXXXXXXXXXXXXXX
XXXXXXXXXXXXXXXXXXXXXXXXXXXXXXXXXXXXXXXXXXXXXXXXXXXXXXXXXXXXXXXXXXXXXXXXXXXXXXXXXXXXXXXXXXXXXXXXXXXXXXXXXXXXXXXXXXXXXXXXXXXXXXX
XXXXXXXXXXXXXXXXXXXXXXXXXXXXXXXXXXXXXXXXXXXXXXXXXXXXXXXXXXXXXXXXXXXXXXXXXXXXXXXXXXXXXXXXXXXXXXXXXXXXXXXXXXXXXXXXXXXXXXXXXXXXXXX
XXXXXXXXXXXXXXXXXXXXXXXXXXXXXXXXXXXXXXXXXXXXXXXXXXXXXXXXXXXXXXXXXXXXXXXXXXXXXXXXXXXXXXXXXXXXXXXXXXXXXXXXXXXXXXXXXXXXXXXXXXXXXXX
XXXXXXXXXXXXXXXXXXXXXXXXXXXXXXXXXXXXXXXXXXXXXXXXXXXXXXXXXXXXXXXXXXXXXXXXXXXXXXXXXXXXXXXXXXXXXXXXXXXXXXXXXXXXXXXXXXXXXXXXXXXXXXX
XXXXXXXXXXXXXXXXXXXXXXXXXXXXXXXXXXXXXXXXXXXXXXXXXXXXXXXXXXXXXXXXXXXXXXXXXXXXXXXXXXXXXXXXXXXXXXXXXXXXXXXXXXXXXXXXXXXXXXXXXXXXXXX
XXXXXXXXXXXXXXXXXXXXXXXXXXXXXXXXXXXXXXXXXXXXXXXXXXXXXXXXXXXXXXXXXXXXXXXXXXXXXXXXXXXXXXXXXXXXXXXXXXXXXXXXXXXXXXXXXXXXXXXXXXXXXXX
XXXXXXXXXXXXXXXXXXXXXXXXXXXXXXXXXXXXXXXXXXXXXXXXXXXXXXXXXXXXXXXXXXXXXXXXXXXXXXXXXXXXXXXXXXXXXXXXXXXXXXXXXXXXXXXXXXXXXXXXXXXXXXX
XXXXXXXXXXXXXXXXXXXXXXXXXXXXXXXXXXXXXXXXXXXXXXXXXXXXXXXXXXXXXXXXXXXXXXXXXXXXXXXXXXXXXXXXXXXXXXXXXXXXXXXXXXXXXXXXXXXXXXXXXXXXXXX
XXXXXXXXXXXXXXXXXXXXXXXXFFFFFFFFFFFFFFFFFFFFFFFFFFXXXXXXXXXXFFFFFFFFFFFFFFFFFFFFFFFFFFFFFFFFFFFFFFFFFFFFFFXXXXXXXXXXXXXXXXXXXXX
XXXXXXXXXXXXXXXXXXXXXXXXFFFFFFFFFFFFFFFFFFFFFFFFFFXXXXXXXXXXFFFFFFFFFFFFFFFFFFFFFFFFFFFFFFFFFFFFFFFFFFFFFFXXXXXXXXXXXXXXXXXXXXX
XXXXXXXXXXXXXXXXXXXXXXXXFTTTTTTTTTTTTTTTTTTTTTTTTFXXXXXXXXXXFTTTTTTTTTTTTTTTTTTTTTTTTTTTTTTTTTTTTTTTTTTTTFXXXXXXXXXXXXXXXXXXXXX
XXXXXXXXXXXXXXXXXXXXXXXXFTTTTTTTTTTTTTTTTTTTTTTTTFXXXXXXXXXXFTTTTTTTTTTTTTTTTTTTTTTTTTTTTTTTTTTTTTTTTTTTTFXXXXXXXXXXXXXXXXXXXXX
XXXXXXXXXXXXXXXXXXXXXXXXFTTTTTTTTTTTTTTTTTTTTTTTTFXXXXXXXXXXFTTTTTTTTTTTTTTTTTTTTTTTTTTTTTTTTTTTTTTTTTTTTFXXXXXXXXXXXXXXXXXXXXX
XXXXXXXXXXXXXXXXXXXXXXXXFTTTTTTTTTTTTTTTTTTTTTTTTFXXXXXXXXXXFTTTTTTTTTTTTTTTTTTTTTTTTTTTTTTTTTTTTTTTTTTTTFXXXXXXXXXXXXXXXXXXXXX
XXXXXXXXXXXXXXXXXXXXXXXXFFFFFFFFFFFFFFFFFFFFFTTTTFXXXXXXXXXXFTTTTFFFFFFFFTTTTFFFFFFFFFFFFTTTTFFFFFFFFTTTTFXXXXXXXXXXXXXXXXXXXXX
XXXXXXXXXXXXXXXXXXXXXXXXXXXXXXXXXXXXXXXXXXXXFTTTTFXXXXXXXXXXFTTTTFXXXXXXFTTTTFXXXXXXXXXXFTTTTFXXXXXXFTTTTFXXXXXXXXXXXXXXXXXXXXX
XXXXXXXXXXXXXXXXXXXXXXXXXXXXXXXXXXXXXXXXXXXXFTTTTFXXXXXXXFFFFTTTTFXXXXXXFTTTTFFFFFFFFFFFFTTTTFXXXXXXFTTTTFXXXXXXXXXXXXXXXXXXXXX
XXXXXXXXXXXXXXXXXXXXXXXXXXXXXXXXXXXXXXXXXXXXFTTTTFFFFFFFFFFFFTTTTFXXXXXXFTTTTFFFFFFFFFFFFTTTTFXXXXXXFTTTTFXXXXXXXXXXXXXXXXXXXXX
XXXXXXXXXXXXXXXXXXXXXXXXXXXXXXXXXXXXXXXXXXXXFTTTTTTTTTTTTTTTTTTTTFXXXXXXFTTTTTTTTTTTTTTTTTTTTFXXXXXXFTTTTFXXXXXXXXXXXXXXXXXXXXX
XXXXXXXXXXXXXXXXXXXXXXXXXXXXXXXXXXXXXXXXXXXXFTTTTTTTTTTTTTTTTTTTTFXXXXXXFTTTTTTTTTTTTTTTTTTTTFXXXXXXFTTTTFXXXXXXXXXXXXXXXXXXXXX
XXXXXXXXXXXXXXXXXXXXXXXXXXXXXXXXXXXXXXXXXXXXFTTTTTTTTTTTTTTTTTTTTFXXXXXXFTTTTTTTTTTTTTTTTTTTTFXXXXXXFTTTTFXXXXXXXXXXXXXXXXXXXXX
XXXXXXXXXXXXXXXXXXXXXXXXXXXXXXXXXXXXXXXXXXXXFTTTTTTTTTTTTTTTTTTTTFXXXXXXFTTTTTTTTTTTTTTTTTTTTFXXXXXXFTTTTFXXXXXXXXXXXXXXXXXXXXX
XXXXXXXXXXXXXXXXXXXXXXXXXXXXXXXXXXXXXXXXXXXXFTTTTFFFFFFFFTTTTFFFFFXXXXXXFFFFFFFFFFFFFFFFFFFFFFXXXXXXFTTTTFXXXXXXXXXXXXXXXXXXXXX
XXXXXXXXXXXXXXXXXXXXXXXXXXXXXXXXXXXXXXXXXXXXFTTTTFXXXXXXFTTTTFXXXXXXXXXXXXXXXXXXXXXXXXXXXXXXXXXXXXXXFTTTTFXXXXXXXXXXXXXXXXXXXXX
XXXXXXXXXXXXXXXXXXXXXXXXFFFFFFFFFFFFFFFFFFFFFTTTTFXXXXXXFTTTTFXXXXXXXXXXXXXXXXXXXXXXXXXXXXXXXXXXXXXXFTTTTFXXXXXXXXXXXXXXXXXXXXX
XXXXXXXXXXXXXXXXXXXXXXXXFFFFFFFFFFFFFFFFFFFFFTTTTFXXXXXXFTTTTFXXXXXXXXXXXXXXXXXXXXXXXXXXXXXXXXXXXXXXFTTTTFXXXXXXXXXXXXXXXXXXXXX
XXXXXXXXXXXXXXXXXXXXXXXXFTTTTTTTTTTTTTTTTTTTTTTTTFXXXXXXFTTTTFXXXXXXXXXXXXXXXXXXXXXXXXXXXXXXXXXXXXXXFFFFFFXXXXXXXXXXXXXXXXXXXXX
XXXXXXXXXXXXXXXXXXXXXXXXFTTTTTTTTTTTTTTTTTTTTTTTTFXXXXXXFTTTTFXXXXXXXXXXXXXXXXXXXXXXXXXXXXXXXXXXXXXXXXXXXXXXXXXXXXXXXXXXXXXXXXX
XXXXXXXXXXXXXXXXXXXXXXXXFTTTTTTTTTTTTTTTTTTTTTTTTFXXXXXXFTTTTFXXXXXXXXXXFFFFFFFFFFXXXXXXXXXXXXXXXXXXXXXXXXXXXXXXXXXXXXXXXXXXXXX
XXXXXXXXXXXXXXXXXXXXXXXXFTTTTTTTTTTTTTTTTTTTTTTTTFXXXXXXFTTTTFXXXXXXXXXXFFFFFFFFFFXXXXXXXXXXXXXXXXXXXXXXXXXXXXXXXXXXXXXXXXXXXXX
XXXXXXXXXXXXXXXXXXXXXXXXFTTTTFFFFFFFFTTTTFFFFFFFFFXXXXXXFTTTTFXXXXXXXXXXFTTTTTTTTFXXXXXXXXXXXXXXXXXXXXXXXXXXXXXXXXXXXXXXXXXXXXX
XXXXXXXXXXXXXXXXXXXXXXXXFTTTTFXXXXXXFTTTTFXXXXXXXXXXXXXXFTTTTFXXXXXXXXXXFTTTTTTTTFXXXXXXXXXXXXXXXXXXXXXXXXXXXXXXXXXXXXXXXXXXXXX
XXXXXXXXXXXXXXXXFFFFFFFFFTTTTFXXXXXXFTTTTFXXXXXXXXXXXXXXFTTTTFXXXXXXXXXXFTTTTTTTTFXXXXXXXXXXXXXXXXXXXXXXXXXXXXXXXXXXXXXXXXXXXXX
XXXXXXXXXXXXXXXXFFFFFFFFFTTTTFXXXXXXFTTTTFXXXXXXXXXXXXXXFTTTTFXXXXXXXXXXFTTTTTTTTFXXXXXXXXXXXXXXXXXXXXXXXXXXXXXXXXXXXXXXXXXXXXX
XXXXXXXXXXXXXXXXFTTTTTTTTTTTTFXXXXXXFTTTTFXXXXXXXXXXXXXXFTTTTFXXXXXXXXXXFTTTTFFFFFXXXXXXXXXXXXXXXXXXXXXXXXXXXXXXXXXXXXXXXXXXXXX
XXXXXXXXXXXXXXXXFTTTTTTTTTTTTFXXXXXXFTTTTFXXXXXXXXXXXXXXFTTTTFXXXXXXXXXXFTTTTFXXXXXXXXXXXXXXXXXXXXXXXXXXXXXXXXXXXXXXXXXXXXXXXXX
XXXXXXXXXXXXXXXXFTTTTTTTTTTTTFXXXXXXFTTTTFXXXXXXXXXXXXXXFTTTTFFFFFFFFFFFFTTTTFXXXXXXXXXXXXXXXXXXXXXXXXXXXXXXXXXXXXXXXXXXXXXXXXX
XXXXXXXXXXXXXXXXFTTTTTTTTTTTTFXXXXXXFTTTTFXXXXXXXXXXXXXXFTTTTFFFFFFFFFFFFTTTTFXXXXXXXXXXXXXXXXXXXXXXXXXXXXXXXXXXXXXXXXXXXXXXXXX
XXXXXXXXXXXXXXXXFTTTTFFFFTTTTFXXXXXXFTTTTFXXXXXXXXXXXXXXFTTTTTTTTTTTTTTTTTTTTFXXXXXXXXXXXXXXXXXXXXXXXXXXXXXXXXXXXXXXXXXXXXXXXXX
XXXXXXXXXXXXXXXXFTTTTFXXFTTTTFXXXXXXFTTTTFXXXXXXXXXXXXXXFTTTTTTTTTTTTTTTTTTTTFXXXXXXXXXXXXXXXXXXXXXXXXXXXXXXXXXXXXXXXXXXXXXXXXX
XXXXXXXXXXXXXXXXFTTTTFXXFTTTTFXXXXXXFTTTTFFFFFXXXXXXXXXXFTTTTTTTTTTTTTTTTTTTTFXXXXXXXXXXXXXXFFFFFFFFFFXXXXXXXXXXXXXXXXXXXXXXXXX
XXXXXXXXXXXXXXXXFTTTTFXXFTTTTFXXXXXXFTTTTFFFFFXXXXXXXXXXFTTTTTTTTTTTTTTTTTTTTFXXXXXXXXXXXXXXFFFFFFFFFFXXXXXXXXXXXXXXXXXXXXXXXXX
XXXXXXXXXXXXXXXXFTTTTFXXFTTTTFXXXXXXFTTTTTTTTFXXXXXXXXXXFFFFFTTTTFFFFFFFFFFFFFXXXXXXXXXXXXXXFTTTTTTTTFXXXXXXXXXXXXXXXXXXXXXXXXX
XXXXXXXXXXXXXXXXFTTTTFXXFTTTTFXXXXXXFTTTTTTTTFXXXXXXXXXXXXXXFTTTTFXXXXXXXXXXXXXXXXXXXXXXXXXXFTTTTTTTTFXXXXXXXXXXXXXXXXXXXXXXXXX
XXXXXXXXXXXXXXXXFTTTTFFFFTTTTFXXXXXXFTTTTTTTTFXXXXXXXXXXXXXXFTTTTFXXXXXXXXXXXXXXXXXXXXXXXXXXFTTTTTTTTFXXXXXXXXXXXXXXXXXXXXXXXXX
XXXXXXXXXXXXXXXXFTTTTFFFFTTTTFXXXXXXFTTTTTTTTFXXXXXXXXXXXXXXFTTTTFXXXXXXXXXXXXXXXXXXXXXXXXXXFTTTTTTTTFXXXXXXXXXXXXXXXXXXXXXXXXX
XXXXXXXXXXXXXXXXFTTTTTTTTTTTTFXXXXXXFTTTTFFFFFXXXXXXXXXXXXXXFTTTTFXXXXXXXXXXXXXXXXXXXXXXXXXXFTTTTFFFFFXXXXXXXXXXXXXXXXXXXXXXXXX
XXXXXXXXXXXXXXXXFTTTTTTTTTTTTFXXXXXXFTTTTFXXXXXXXXXXXXXXXXXXFTTTTFXXXXXXXXXXXXXXXXXXXXXXXXXXFTTTTFXXXXXXXXXXXXXXXXXXXXXXXXXXXXX
XXXXXXXXXXXXXXXXFTTTTTTTTTTTTFXXXXXXFTTTTFXXXXXXXXXXFFFFFFFFFTTTTFFFFFFFFFXXXXXXFFFFFFFFFFFFFTTTTFXXXXXXXXXXXXXXXXXXXXXXXXXXXXX
XXXXXXXXXXXXXXXXFTTTTTTTTTTTTFXXXXXXFTTTTFXXXXXXXXXXFFFFFFFFFTTTTFFFFFFFFFXXXXXXFFFFFFFFFFFFFTTTTFXXXXXXXXXXXXXXXXXXXXXXXXXXXXX
XXXXXXXXXXXXXXXXFFFFFFFFFTTTTFXXXXXXFTTTTFXXXXXXXXXXFTTTTTTTTTTTTTTTTTTTTFXXXXXXFTTTTTTTTTTTTTTTTFXXXXXXXXXXXXXXXXXXXXXXXXXXXXX
XXXXXXXXXXXXXXXXXXXXXXXXFTTTTFXXXXXXFTTTTFXXXXXXXXXXFTTTTTTTTTTTTTTTTTTTTFXXXXXXFTTTTTTTTTTTTTTTTFXXXXXXXXXXXXXXXXXXXXXXXXXXXXX
XXXXXXXXXXXXXXXXXXXXXXXXFTTTTFXXXXXXFTTTTFXXXXXXXXXXFTTTTTTTTTTTTTTTTTTTTFXXXXXXFTTTTTTTTTTTTTTTTFXXXXXXXXXXXXXXXXXXXXXXXXXXXXX
XXXXXXXXXXXXXXXXXXXXXXXXFTTTTFXXXXXXFTTTTFXXXXXXXXXXFTTTTTTTTTTTTTTTTTTTTFXXXXXXFTTTTTTTTTTTTTTTTFXXXXXXXXXXXXXXXXXXXXXXXXXXXXX
XXXXXXXXXXXXXXXXXXXXXXXXFTTTTFXXXXXXFTTTTFXXXXXXXXXXFTTTTFFFFTTTTFFFFTTTTFXXXXXXFTTTTFFFFFFFFFFFFFXXXXXXXXXXXXXXXXXXXXXXXXXXXXX
XXXXXXXXXXXXXXXXXXXXXXXXFTTTTFXXXXXXFTTTTFXXXXXXXXXXFTTTTFXXFTTTTFXXFTTTTFXXXXXXFTTTTFXXXXXXXXXXXXXXXXXXXXXXXXXXXXXXXXXXXXXXXXX
XXXXXXXXXXXXXXXXXXXXFFFFFTTTTFFFFFFFFTTTTFFFFXXXXXXXFTTTTFFFFTTTTFFFFTTTTFXXXXXXFTTTTFXXXXXXXXXXXXXXXXXXXXXXXXXXXXXXXXXXXXXXXXX
XXXXXXXXXXXXXXXXXXXXFFFFFTTTTFFFFFFFFTTTTFFFFFFFFFFFFTTTTFFFFTTTTFFFFTTTTFFFFFFFFTTTTFXXXXXXXXXXXXXXXXXXXXXXXXXXXXXXXXXXXXXXXXX
XXXXXXXXXXXXXXXXXXXXFTTTTTTTTTTTTTTTTTTTTTTTTTTTTTTTTTTTTTTTTTTTTTTTTTTTTTTTTTTTTTTTTFXXXXXXXXXXXXXXXXXXXXXXXXXXXXXXXXXXXXXXXXX
XXXXXXXXXXXXXXXXXXXXFTTTTTTTTTTTTTTTTTTTTTTTTTTTTTTTTTTTTTTTTTTTTTTTTTTTTTTTTTTTTTTTTFXXXXXXXXXXXXXXXXXXXXXXXXXXXXXXXXXXXXXXXXX
XXXXXXXXXXXXXXXXXXXXFTTTTTTTTTTTTTTTTTTTTTTTTTTTTTTTTTTTTTTTTTTTTTTTTTTTTTTTTTTTTTTTTFXXXXXXXXXXXXXXXXXXXXXXXXXXXXXXXXXXXXXXXXX
XXXXXXXXXXXXXXXXXXXXFTTTTTTTTTTTTTTTTTTTTTTTTTTTTTTTTTTTTTTTTTTTTTTTTTTTTTTTTTTTTTTTTFXXXXXXXXXXXXXXXXXXXXXXXXXXXXXXXXXXXXXXXXX
XXXXXXXXXXXXXXXXXXXXFFFFFFFFFFFFFFFFFTTTTFFFFFFFFFFFFTTTTFFFFTTTTFFFFTTTTFFFFFFFFTTTTFXXXXXXXXXXXXXXXXXXXXXXXXXXXXXXXXXXXXXXXXX
XXXXXXXXXXXXXXXXXXXXXXXXXXXXXXXXXXXXFTTTTFXXXXXXXXXXFTTTTFXXFTTTTFXXFTTTTFXXXXXXFTTTTFXXXXXXXXXXXXXXXXXXXXXXXXXXXXXXXXXXXXXXXXX
XXXXXXXXXXXXXXXXXXXXXXXXXXXXXXXXXXXXFTTTTFXXXXXXXXXXFTTTTFFFFTTTTFFFFTTTTFXXXXXXFTTTTFFFFFFFFFFFFFXXXXXXXXXXXXXXXXXXXXXXXXXXXXX
XXXXXXXXXXXXXXXXXXXXXXXXXXXXXXXXXXXXFTTTTFXXXXXXXXXXFTTTTFFFFTTTTFFFFTTTTFXXXXXXFTTTTFFFFFFFFFFFFFXXXXXXXXXXXXXXXXXXXXXXXXXXXXX
XXXXXXXXXXXXXXXXXXXXXXXXXXXXXXXXXXXXFTTTTFXXXXXXXXXXFTTTTTTTTTTTTTTTTTTTTFXXXXXXFTTTTTTTTTTTTTTTTFXXXXXXXXXXXXXXXXXXXXXXXXXXXXX
XXXXXXXXXXXXXXXXXXXXXXXXXXXXXXXXXXXXFTTTTFXXXXXXXXXXFTTTTTTTTTTTTTTTTTTTTFXXXXXXFTTTTTTTTTTTTTTTTFXXXXXXXXXXXXXXXXXXXXXXXXXXXXX
XXXXXXXXXXXXXXXXXXXXFFFFFFFFFFFFFFFFFTTTTFXXXXXXXXXXFTTTTTTTTTTTTTTTTTTTTFXXXXXXFTTTTTTTTTTTTTTTTFXXXXXXXXXXXXXXXXXXXXXXXXXXXXX
XXXXXXXXXXXXXXXXXXXXFFFFFFFFFFFFFFFFFTTTTFXXXXXXXXXXFTTTTTTTTTTTTTTTTTTTTFXXXXXXFTTTTTTTTTTTTTTTTFXXXXXXXXXXXXXXXXXXXXXXXXXXXXX
XXXXXXXXXXXXXXXXXXXXFTTTTTTTTTTTTTTTTTTTTFXXXXXXXXXXFFFFFFFFFTTTTFFFFFFFFFXXXXXXFFFFFFFFFFFFFTTTTFXXXXXXXXXXXXXXXXXXXXXXXXXXXXX
XXXXXXXXXXXXXXXXXXXXFTTTTTTTTTTTTTTTTTTTTFXXXXXXXXXXXXXXXXXXFTTTTFXXXXXXXXXXXXXXXXXXXXXXXXXXFTTTTFXXXXXXXXXXXXXXXXXXXXXXXXXXXXX
XXXXXXXXXXXXXXXXXXXXFTTTTTTTTTTTTTTTTTTTTFXXXXXXXXXXXXXXXXXXFTTTTFXXXXXXXXXXXXXXXXXXXXXXXXXXFTTTTFFFFFXXXXXXXXXXXXXXXXXXXXXXXXX
XXXXXXXXXXXXXXXXXXXXFTTTTTTTTTTTTTTTTTTTTFXXXXXXXXXXXXXXXXXXFTTTTFXXXXXXXXXXXXXXXXXXXXXXXXXXFTTTTFFFFFXXXXXXXXXXXXXXXXXXXXXXXXX
XXXXXXXXXXXXXXXXXXXXFTTTTFFFFFFFFTTTTFFFFFXXXXXXXXXXXXXXXXXXFTTTTFXXXXXXXXXXXXXXXXXXXXXXXXXXFTTTTTTTTFXXXXXXXXXXXXXXXXXXXXXXXXX
XXXXXXXXXXXXXXXXXXXXFTTTTFXXXXXXFTTTTFXXXXXXXXXXXXXXXXXXXXXXFTTTTFXXXXXXXXXXXXXXXXXXXXXXXXXXFTTTTTTTTFXXXXXXXXXXXXXXXXXXXXXXXXX
XXXXXXXXXXXXXXXXXXXXFTTTTFXXXXXXFTTTTFXXXXXXXXXXFFFFFFXXXXXXFTTTTFXXXXXXXXXXXXXXXXXXXXXXXXXXFTTTTTTTTFXXXXXXXXXXXXXXXXXXXXXXXXX
XXXXXXXXXXXXXXXXXXXXFTTTTFXXXXXXFTTTTFXXXXXXXXXXFFFFFFXXXXXXFTTTTFXXXXXXXXXXXXXXXXXXXXXXXXXXFTTTTTTTTFXXXXXXXXXXXXXXXXXXXXXXXXX
XXXXXXXXXXXXXXXXXXXXFTTTTFXXXXXXFFFFFFXXXXXXXXXXFTTTTFXXXXXXFTTTTFXXXXXXXXXXXXXXXXXXXXXXXXXXFFFFFFFFFFXXXXXXXXXXXXXXXXXXXXXXXXX
XXXXXXXXXXXXXXXXXXXXFTTTTFXXXXXXXXXXXXXXXXXXXXXXFTTTTFXXXXXXFTTTTFXXXXXXXXXXXXXXXXXXXXXXXXXXXXXXXXXXXXXXXXXXXXXXXXXXXXXXXXXXXXX
XXXXXXXXXXXXXXXXXXXXFTTTTFXXXXXXXXXXXXXXXXXXXXXXFTTTTFXXXXXXFTTTTFFFFFFFFFFFFFXXXXXXXXXXXXXXXXXXXXXXXXXXXXXXXXXXXXXXXXXXXXXXXXX
XXXXXXXXXXXXXXXXXXXXFTTTTFXXXXXXXXXXXXXXXXXXXXXXFTTTTFXXXXXXFTTTTFFFFFFFFFFFFFXXXXXXXXXXXXXXXXXXXXXXXXXXXXXXXXXXXXXXXXXXXXXXXXX
XXXXXXXXXXXXXXXXXXXXFTTTTFXXXXXXXXXXXXXXXXXXXXXXFTTTTFXXXXXXFTTTTTTTTTTTTTTTTFXXXXXXXXXXXXXXXXXXXXXXXXXXXXXXXXXXXXXXXXXXXXXXXXX
XXXXXXXXXXXXXXXXXXXXFTTTTFXXXXXXXXXXXXXXXXXXXXXXFTTTTFXXXXXXFTTTTTTTTTTTTTTTTFXXXXXXXXXXXXXXXXXXXXXXXXXXXXXXXXXXXXXXXXXXXXXXXXX
XXXXXXXXXXXXXXXXXXXXFTTTTFXXXXXXXXXXXXXXXXXXXXXXFTTTTFXXXXXXFTTTTTTTTTTTTTTTTFXXXXXXXXXXXXXXXXXXFFFFFFFFFFXXXXXXXXXXXXXXXXXXXXX
XXXXXXXXXXXXXXXXXXXXFTTTTFXXXXXXXXXXXXXXXXXXXXXXFTTTTFXXXXXXFTTTTTTTTTTTTTTTTFXXXXXXXXXXXXXXXXXXFFFFFFFFFFXXXXXXXXXXXXXXXXXXXXX
XXXXXXXXXXXXXXXXXXXXFTTTTFXXXXXXXXXXXXXXXXXXXXXXFTTTTFXXXXXXFTTTTFFFFFFFFFFFFFXXXXXXXXXXXXXXXXXXFTTTTTTTTFXXXXXXXXXXXXXXXXXXXXX
XXXXXXXXXXXXXXXXXXXXFTTTTFXXXXXXXXXXXXXXXXXXXXXXFTTTTFXXXXXXFTTTTFXXXXXXXXXXXXXXXXXXXXXXXXXXXXXXFTTTTTTTTFXXXXXXXXXXXXXXXXXXXXX
XXXXXXXXXXXXXXXXXXXXFTTTTFFFFFFFFFFFFFFFFFXXXXXXFTTTTFFFFFFFFTTTTFXXXXXXXXXXXXXXXXXXFFFFFXXXXXXXFTTTTTTTTFFFFFXXXXXXXXXXXXXXXXX
XXXXXXXXXXXXXXXXXXXXFTTTTFFFFFFFFFFFFFFFFFXXXXXXFTTTTFFFFFFFFTTTTFXXXXXXXXXXXXXXXXXXFFFFFFFFFFFFFTTTTTTTTFFFFFXXXXXXXXXXXXXXXXX
XXXXXXXXXXXXXXXXXXXXFTTTTTTTTTTTTTTTTTTTTFXXXXXXFTTTTTTTTTTTTTTTTFXXXXXXXXXXXXXXXXXXFTTTTTTTTTTTTTTTTTTTTTTTTFXXXXXXXXXXXXXXXXX
XXXXXXXXXXXXXXXXXXXXFTTTTTTTTTTTTTTTTTTTTFXXXXXXFTTTTTTTTTTTTTTTTFXXXXXXXXXXXXXXXXXXFTTTTTTTTTTTTTTTTTTTTTTTTFXXXXXXXXXXXXXXXXX
XXXXXXXXXXXXXXXXXXXXFTTTTTTTTTTTTTTTTTTTTFXXXXXXFTTTTTTTTTTTTTTTTFXXXXXXFFFFFFXXXXXXFTTTTTTTTTTTTTTTTTTTTTTETFXXXXXXXXXXXXXXXXX
XXXXXXXXXXXXXXXXXXXXFTTTTTTTTTTTTTTTTTTTTFXXXXXXFTTTTTTTTTTTTTTTTFXXXXXXFFFFFFXXXXXXFTTTTTTTTTTTTTTTTTTTTTTTTFXXXXXXXXXXXXXXXXX
XXXXXXXXXXXXXXXXXXXXFTTTTFFFFFFFFFFFFTTTTFXXXXXXFFFFFFFFFFFFFTTTTFXXXXXXFTTTTFXXXXXXFTTTTFFFFFFFFTTTTTTTTFFFFFXXXXXXXXXXXXXXXXX
XXXXXXXXXXXXXXXXXXXXFTTTTFXXXXXXXXXXFTTTTFXXXXXXXXXXXXXXXXXXFTTTTFXXXXXXFTTTTFXXXXXXFTTTTFXXXXXXFTTTTTTTTFXXXXXXXXXXXXXXXXXXXXX
XXXXXXXXXXXXXXXXXXXXFTTTTFXXXXXXXXXXFTTTTFXXXXXXXXXXXXXXXXXXFTTTTFFFFFFFFTTTTFFFFFFFFTTTTFXXXXXXFTTTTTTTTFXXXXXXXXXXXXXXXXXXXXX
XXXXXXXXXXXXXXXXXXXXFTTTTFXXXXXXXXXXFTTTTFXXXXXXXXXXXXXXXXXXFTTTTFFFFFFFFTTTTFFFFFFFFTTTTFXXXXXXFTTTTTTTTFXXXXXXXXXXXXXXXXXXXXX
XXXXXXXXXXXXXXXXXXXXFTTTTFXXXXXXXXXXFTTTTFXXXXXXXXXXXXXXXXXXFTTTTTTTTTTTTTTTTTTTTTTTTTTTTFXXXXXXFFFFFFFFFFXXXXXXXXXXXXXXXXXXXXX
XXXXXXXXXXXXXXXXXXXXFTTTTFXXXXXXXXXXFTTTTFXXXXXXXXXXXXXXXXXXFTTTTTTTTTTTTTTTTTTTTTTTTTTTTFXXXXXXXXXXXXXXXXXXXXXXXXXXXXXXXXXXXXX
XXXXXXXXXXXXXXXXXXXXFTTTTFXXXXXXXXXXFTTTTFXXXXXXXXXXXXXXXXXXFTTTTTTTTTTTTTTTTTTTTTTTTTTTTFXXXXXXXXXXXXXXXXXXXXXXXXXXXXXXXXXXXXX
XXXXXXXXXXXXXXXXXXXXFTTTTFXXXXXXXXXXFTTTTFXXXXXXXXXXXXXXXXXXFTTTTTTTTTTTTTTTTTTTTTTTTTTTTFXXXXXXXXXXXXXXXXXXXXXXXXXXXXXXXXXXXXX
XXXXXXXXXXXXXXXXXXXXFTTTTFXXXXXXXXXXFTTTTFXXXXXXXXXXXXXXXXXXFTTTTFFFFFFFFTTTTFFFFFFFFFFFFFXXXXXXXXXXXXXXXXXXXXXXXXXXXXXXXXXXXXX
XXXXXXXXXXXXXXXXXXXXFTTTTFXXXXXXXXXXFTTTTFXXXXXXXXXXXXXXXXXXFTTTTFXXXXXXFTTTTFXXXXXXXXXXXXXXXXXXXXXXXXXXXXXXXXXXXXXXXXXXXXXXXXX
XXXXXXXXXXXXXXXXXXXXFTTTTFXXXXXXXXXXFTTTTFFFFFFFFFFFFFFFFFFFFTTTTFXXXXXXFTTTTFXXXXXXXXXXXXXXXXXXXXXXXXXXXXXXXXXXXXXXXXXXXXXXXXX
XXXXXXXXXXXXXXXXXXXXFTTTTFXXXXXXXXXXFTTTTFFFFFFFFFFFFFFFFFFFFTTTTFXXXXXXFTTTTFXXXXXXXXXXXXXXXXXXXXXXXXXXXXXXXXXXXXXXXXXXXXXXXXX
XXXXXXXXXXXXXXXXXXXXFFFFFFXXXXXXXXXXFTTTTTTTTTTTTTTTTTTTTTTTTTTTTFXXXXXXFTTTTFXXXXXXXXXXXXXXXXXXXXXXXXXXXXXXXXXXXXXXXXXXXXXXXXX
XXXXXXXXXXXXXXXXXXXXXXXXXXXXXXXXXXXXFTTTTTTTTTTTTTTTTTTTTTTTTTTTTFXXXXXXFTTTTFXXXXXXXXXXXXXXXXXXXXXXXXXXXXXXXXXXXXXXXXXXXXXXXXX
XXXXXXXXXXXXXXXXXXXXXXXXXXXXXXXXXXXXFTTTTTTTTTTTTTTTTTTTTTTTTTTTTFXXXXXXFTTTTFFFFFFFFFFFFFXXXXXXXXXXXXXXXXXXXXXXXXXXXXXXXXXXXXX
XXXXXXXXXXXXXXXXXXXXXXXXXXXXXXXXXXXXFTTTTTTTTTTTTTTTTTTTTTTTTTTTTFXXXXXXFTTTTFFFFFFFFFFFFFXXXXXXXXXXXXXXXXXXXXXXXXXXXXXXXXXXXXX
XXXXXXXXXXXXXXXXXXXXXXXXXXXXXXXXXXXXFFFFFFFFFFFFFFFFFFFFFFFFFFFFFFXXXXXXFTTTTTTTTTTTTTTTTFXXXXXXXXXXXXXXXXXXXXXXXXXXXXXXXXXXXXX
XXXXXXXXXXXXXXXXXXXXXXXXXXXXXXXXXXXXXXXXXXXXXXXXXXXXXXXXXXXXXXXXXXXXXXXXFTTTTTTTTTTTTTTTTFXXXXXXXXXXXXXXXXXXXXXXXXXXXXXXXXXXXXX
XXXXXXXXXXXXXXXXXXXXXXXXXXXXXXXXXXXXXXXXXXXXXXXXXXXXXXXXXXXXXXXXXXXXXXXXFTTTTTTTTTTTTTTTTFXXXXXXXXXXXXXXXXXXXXXXXXXXXXXXXXXXXXX
XXXXXXXXXXXXXXXXXXXXXXXXXXXXXXXXXXXXXXXXXXXXXXXXXXXXXXXXXXXXXXXXXXXXXXXXFTTTTTTTTTTTTTTTTFXXXXXXXXXXXXXXXXXXXXXXXXXXXXXXXXXXXXX
XXXXXXXXXXXXXXXXXXXXXXXXXXXXXXXXXXXXXXXXXXXXXXXXXXXXXXXXXXXXXXXXXXXXXXXXFFFFFFFFFFFFFFFFFFXXXXXXXXXXXXXXXXXXXXXXXXXXXXXXXXXXXXX
XXXXXXXXXXXXXXXXXXXXXXXXXXXXXXXXXXXXXXXXXXXXXXXXXXXXXXXXXXXXXXXXXXXXXXXXXXXXXXXXXXXXXXXXXXXXXXXXXXXXXXXXXXXXXXXXXXXXXXXXXXXXXXX
XXXXXXXXXXXXXXXXXXXXXXXXXXXXXXXXXXXXXXXXXXXXXXXXXXXXXXXXXXXXXXXXXXXXXXXXXXXXXXXXXXXXXXXXXXXXXXXXXXXXXXXXXXXXXXXXXXXXXXXXXXXXXXX
XXXXXXXXXXXXXXXXXXXXXXXXXXXXXXXXXXXXXXXXXXXXXXXXXXXXXXXXXXXXXXXXXXXXXXXXXXXXXXXXXXXXXXXXXXXXXXXXXXXXXXXXXXXXXXXXXXXXXXXXXXXXXXX
XXXXXXXXXXXXXXXXXXXXXXXXXXXXXXXXXXXXXXXXXXXXXXXXXXXXXXXXXXXXXXXXXXXXXXXXXXXXXXXXXXXXXXXXXXXXXXXXXXXXXXXXXXXXXXXXXXXXXXXXXXXXXXX
XXXXXXXXXXXXXXXXXXXXXXXXXXXXXXXXXXXXXXXXXXXXXXXXXXXXXXXXXXXXXXXXXXXXXXXXXXXXXXXXXXXXXXXXXXXXXXXXXXXXXXXXXXXXXXXXXXXXXXXXXXXXXXX
XXXXXXXXXXXXXXXXXXXXXXXXXXXXXXXXXXXXXXXXXXXXXXXXXXXXXXXXXXXXXXXXXXXXXXXXXXXXXXXXXXXXXXXXXXXXXXXXXXXXXXXXXXXXXXXXXXXXXXXXXXXXXXX
XXXXXXXXXXXXXXXXXXXXXXXXXXXXXXXXXXXXXXXXXXXXXXXXXXXXXXXXXXXXXXXXXXXXXXXXXXXXXXXXXXXXXXXXXXXXXXXXXXXXXXXXXXXXXXXXXXXXXXXXXXXXXXX
XXXXXXXXXXXXXXXXXXXXXXXXXXXXXXXXXXXXXXXXXXXXXXXXXXXXXXXXXXXXXXXXXXXXXXXXXXXXXXXXXXXXXXXXXXXXXXXXXXXXXXXXXXXXXXXXXXXXXXXXXXXXXXX
XXXXXXXXXXXXXXXXXXXXXXXXXXXXXXXXXXXXXXXXXXXXXXXXXXXXXXXXXXXXXXXXXXXXXXXXXXXXXXXXXXXXXXXXXXXXXXXXXXXXXXXXXXXXXXXXXXXXXXXXXXXXXXX